1111111
1p000C1
10C0CE1
1111111
