1111111
1P0X0C1
10C0CE1
1111111
