1111111
1000111
1000111
100CPE1
1111111
