111111111111111
1E000000C000001
100000C000000P1
111111111111111
