111111111111111111111111111111111
1P1000100000000000000000000000001
101010101111101111111111111110101
101010100000100000000000000C101C1
101010111110111111111111111110111
10001010000010000000C1000000000C1
111110101111101111111101111111111
1C0000001C000000000000000000000E1
111111111111111111111111111111111
