1111111
1P0C001
1111111
10C00E1
1111111
