111111111
1P0C00001
111111101
1C0000C01
101111111
10C0000E1
111111111
